Date,Credit,Debit,Balance,Transaction Detail,Category,Subcategory
01-Jan-25,-,1186.7,148813.3,Zomato Order,Lifestyle & Entertainment,Dining & Restaurants
01-Jan-25,-,2890.87,145922.43,BigBasket Groceries,Food & Grocery,Online Grocery Services
01-Jan-25,-,499.0,145423.43,Netflix Subscription,Lifestyle & Entertainment,Subscription Services
01-Jan-25,-,499.0,144924.43,Netflix Subscription,Lifestyle & Entertainment,Subscription Services
01-Jan-25,77667.33,-,222591.76,Infosys Salary Credit,Income & Credits,Salary & Wages
02-Jan-25,-,2997.14,219594.62,BigBasket Groceries,Food & Grocery,Online Grocery Services
02-Jan-25,-,499.0,219095.62,Netflix Subscription,Lifestyle & Entertainment,Subscription Services
02-Jan-25,-,1038.14,218057.48,Zomato Order,Lifestyle & Entertainment,Dining & Restaurants
03-Jan-25,-,1716.73,216340.75,BigBasket Groceries,Food & Grocery,Online Grocery Services
03-Jan-25,-,499.0,215841.75,Netflix Subscription,Lifestyle & Entertainment,Subscription Services
03-Jan-25,-,2019.78,213821.97,Amazon India,Shopping,Clothing & Accessories
04-Jan-25,-,2498.07,211323.9,Amazon India,Shopping,Clothing & Accessories
04-Jan-25,-,2407.4,208916.5,BigBasket Groceries,Food & Grocery,Online Grocery Services
04-Jan-25,-,1380.7,207535.8,Zomato Order,Lifestyle & Entertainment,Dining & Restaurants
04-Jan-25,-,499.0,207036.8,Netflix Subscription,Lifestyle & Entertainment,Subscription Services
05-Jan-25,-,589.19,206447.61,Zomato Order,Lifestyle & Entertainment,Dining & Restaurants
05-Jan-25,-,776.6,205671.01,Amazon India,Shopping,Clothing & Accessories
05-Jan-25,-,987.04,204683.97,Zomato Order,Lifestyle & Entertainment,Dining & Restaurants
05-Jan-25,-,1113.54,203570.43,Zomato Order,Lifestyle & Entertainment,Dining & Restaurants
06-Jan-25,-,864.81,202705.62,Zomato Order,Lifestyle & Entertainment,Dining & Restaurants
06-Jan-25,-,499.0,202206.62,Netflix Subscription,Lifestyle & Entertainment,Subscription Services
06-Jan-25,-,2994.46,199212.16,BigBasket Groceries,Food & Grocery,Online Grocery Services
06-Jan-25,-,1398.75,197813.41,Amazon India,Shopping,Clothing & Accessories
07-Jan-25,-,873.08,196940.33,Amazon India,Shopping,Clothing & Accessories
07-Jan-25,-,499.0,196441.33,Netflix Subscription,Lifestyle & Entertainment,Subscription Services
07-Jan-25,-,751.61,195689.72,Amazon India,Shopping,Clothing & Accessories
08-Jan-25,-,499.0,195190.72,Netflix Subscription,Lifestyle & Entertainment,Subscription Services
08-Jan-25,-,499.0,194691.72,Netflix Subscription,Lifestyle & Entertainment,Subscription Services
08-Jan-25,-,499.0,194192.72,Netflix Subscription,Lifestyle & Entertainment,Subscription Services
08-Jan-25,-,705.46,193487.26,Zomato Order,Lifestyle & Entertainment,Dining & Restaurants
09-Jan-25,-,1330.26,192157.0,Amazon India,Shopping,Clothing & Accessories
09-Jan-25,-,1023.64,191133.36,BigBasket Groceries,Food & Grocery,Online Grocery Services
09-Jan-25,-,707.76,190425.6,Zomato Order,Lifestyle & Entertainment,Dining & Restaurants
10-Jan-25,-,499.0,189926.6,Netflix Subscription,Lifestyle & Entertainment,Subscription Services
10-Jan-25,-,1031.96,188894.64,BigBasket Groceries,Food & Grocery,Online Grocery Services
10-Jan-25,-,1220.4,187674.24,Amazon India,Shopping,Clothing & Accessories
10-Jan-25,-,1130.66,186543.58,Zomato Order,Lifestyle & Entertainment,Dining & Restaurants
11-Jan-25,-,867.08,185676.5,Amazon India,Shopping,Clothing & Accessories
11-Jan-25,-,2170.56,183505.94,Amazon India,Shopping,Clothing & Accessories
11-Jan-25,-,2284.18,181221.76,BigBasket Groceries,Food & Grocery,Online Grocery Services
11-Jan-25,-,499.0,180722.76,Netflix Subscription,Lifestyle & Entertainment,Subscription Services
12-Jan-25,-,499.0,180223.76,Netflix Subscription,Lifestyle & Entertainment,Subscription Services
12-Jan-25,-,2798.47,177425.29,BigBasket Groceries,Food & Grocery,Online Grocery Services
12-Jan-25,-,2249.54,175175.75,BigBasket Groceries,Food & Grocery,Online Grocery Services
13-Jan-25,-,1617.12,173558.63,Amazon India,Shopping,Clothing & Accessories
13-Jan-25,-,862.2,172696.43,Zomato Order,Lifestyle & Entertainment,Dining & Restaurants
13-Jan-25,-,499.0,172197.43,Netflix Subscription,Lifestyle & Entertainment,Subscription Services
14-Jan-25,-,749.96,171447.47,Amazon India,Shopping,Clothing & Accessories
14-Jan-25,-,1813.19,169634.28,BigBasket Groceries,Food & Grocery,Online Grocery Services
14-Jan-25,-,1044.68,168589.6,Amazon India,Shopping,Clothing & Accessories
14-Jan-25,-,1035.99,167553.61,Zomato Order,Lifestyle & Entertainment,Dining & Restaurants
15-Jan-25,-,2077.17,165476.44,Amazon India,Shopping,Clothing & Accessories
15-Jan-25,-,2243.3,163233.14,Amazon India,Shopping,Clothing & Accessories
15-Jan-25,-,1007.52,162225.62,Zomato Order,Lifestyle & Entertainment,Dining & Restaurants
16-Jan-25,-,1168.76,161056.86,BigBasket Groceries,Food & Grocery,Online Grocery Services
16-Jan-25,-,499.0,160557.86,Netflix Subscription,Lifestyle & Entertainment,Subscription Services
16-Jan-25,-,499.0,160058.86,Netflix Subscription,Lifestyle & Entertainment,Subscription Services
16-Jan-25,-,499.0,159559.86,Netflix Subscription,Lifestyle & Entertainment,Subscription Services
17-Jan-25,-,2834.87,156724.99,BigBasket Groceries,Food & Grocery,Online Grocery Services
17-Jan-25,-,717.28,156007.71,Amazon India,Shopping,Clothing & Accessories
17-Jan-25,-,1450.73,154556.98,BigBasket Groceries,Food & Grocery,Online Grocery Services
18-Jan-25,-,499.0,154057.98,Netflix Subscription,Lifestyle & Entertainment,Subscription Services
18-Jan-25,-,1775.42,152282.56,Amazon India,Shopping,Clothing & Accessories
18-Jan-25,-,959.7,151322.86,Zomato Order,Lifestyle & Entertainment,Dining & Restaurants
18-Jan-25,-,499.0,150823.86,Netflix Subscription,Lifestyle & Entertainment,Subscription Services
19-Jan-25,-,1703.01,149120.85,BigBasket Groceries,Food & Grocery,Online Grocery Services
19-Jan-25,-,499.0,148621.85,Netflix Subscription,Lifestyle & Entertainment,Subscription Services
19-Jan-25,-,1988.24,146633.61,Amazon India,Shopping,Clothing & Accessories
19-Jan-25,-,2406.92,144226.69,BigBasket Groceries,Food & Grocery,Online Grocery Services
20-Jan-25,-,499.0,143727.69,Netflix Subscription,Lifestyle & Entertainment,Subscription Services
20-Jan-25,-,2446.95,141280.74,Amazon India,Shopping,Clothing & Accessories
20-Jan-25,-,1062.96,140217.78,BigBasket Groceries,Food & Grocery,Online Grocery Services
20-Jan-25,-,499.0,139718.78,Netflix Subscription,Lifestyle & Entertainment,Subscription Services
21-Jan-25,-,2807.22,136911.56,BigBasket Groceries,Food & Grocery,Online Grocery Services
21-Jan-25,-,580.86,136330.7,Zomato Order,Lifestyle & Entertainment,Dining & Restaurants
21-Jan-25,-,1242.91,135087.79,BigBasket Groceries,Food & Grocery,Online Grocery Services
21-Jan-25,-,901.58,134186.21,Amazon India,Shopping,Clothing & Accessories
22-Jan-25,-,499.0,133687.21,Netflix Subscription,Lifestyle & Entertainment,Subscription Services
22-Jan-25,-,499.0,133188.21,Netflix Subscription,Lifestyle & Entertainment,Subscription Services
22-Jan-25,-,1164.79,132023.42,Amazon India,Shopping,Clothing & Accessories
23-Jan-25,-,572.21,131451.21,Zomato Order,Lifestyle & Entertainment,Dining & Restaurants
23-Jan-25,-,499.0,130952.21,Netflix Subscription,Lifestyle & Entertainment,Subscription Services
23-Jan-25,-,2715.38,128236.83,BigBasket Groceries,Food & Grocery,Online Grocery Services
23-Jan-25,-,725.93,127510.9,Zomato Order,Lifestyle & Entertainment,Dining & Restaurants
24-Jan-25,-,1178.67,126332.23,Zomato Order,Lifestyle & Entertainment,Dining & Restaurants
24-Jan-25,-,499.0,125833.23,Netflix Subscription,Lifestyle & Entertainment,Subscription Services
24-Jan-25,-,2199.59,123633.64,BigBasket Groceries,Food & Grocery,Online Grocery Services
25-Jan-25,-,499.0,123134.64,Netflix Subscription,Lifestyle & Entertainment,Subscription Services
25-Jan-25,-,499.0,122635.64,Netflix Subscription,Lifestyle & Entertainment,Subscription Services
25-Jan-25,-,567.27,122068.37,Zomato Order,Lifestyle & Entertainment,Dining & Restaurants
25-Jan-25,-,499.0,121569.37,Netflix Subscription,Lifestyle & Entertainment,Subscription Services
26-Jan-25,-,1156.84,120412.53,Zomato Order,Lifestyle & Entertainment,Dining & Restaurants
26-Jan-25,-,1475.75,118936.78,BigBasket Groceries,Food & Grocery,Online Grocery Services
26-Jan-25,-,535.07,118401.71,Zomato Order,Lifestyle & Entertainment,Dining & Restaurants
27-Jan-25,-,800.98,117600.73,Zomato Order,Lifestyle & Entertainment,Dining & Restaurants
27-Jan-25,-,1480.31,116120.42,BigBasket Groceries,Food & Grocery,Online Grocery Services
27-Jan-25,-,1185.45,114934.97,Amazon India,Shopping,Clothing & Accessories
28-Jan-25,-,1082.12,113852.85,Zomato Order,Lifestyle & Entertainment,Dining & Restaurants
28-Jan-25,-,1954.06,111898.79,Amazon India,Shopping,Clothing & Accessories
28-Jan-25,-,737.56,111161.23,Amazon India,Shopping,Clothing & Accessories
28-Jan-25,-,499.0,110662.23,Netflix Subscription,Lifestyle & Entertainment,Subscription Services
29-Jan-25,-,1521.67,109140.56,Amazon India,Shopping,Clothing & Accessories
29-Jan-25,-,1793.85,107346.71,Amazon India,Shopping,Clothing & Accessories
29-Jan-25,-,1485.16,105861.55,Zomato Order,Lifestyle & Entertainment,Dining & Restaurants
30-Jan-25,-,1215.49,104646.06,BigBasket Groceries,Food & Grocery,Online Grocery Services
30-Jan-25,-,1398.01,103248.05,BigBasket Groceries,Food & Grocery,Online Grocery Services
30-Jan-25,-,906.08,102341.97,Zomato Order,Lifestyle & Entertainment,Dining & Restaurants
31-Jan-25,-,2428.88,99913.09,Amazon India,Shopping,Clothing & Accessories
31-Jan-25,-,1490.53,98422.56,Zomato Order,Lifestyle & Entertainment,Dining & Restaurants
31-Jan-25,-,2133.74,96288.82,BigBasket Groceries,Food & Grocery,Online Grocery Services
31-Jan-25,-,499.0,95789.82,Netflix Subscription,Lifestyle & Entertainment,Subscription Services
01-Feb-25,-,1234.06,94555.76,Amazon India,Shopping,Clothing & Accessories
01-Feb-25,-,499.0,94056.76,Netflix Subscription,Lifestyle & Entertainment,Subscription Services
01-Feb-25,-,895.35,93161.41,Zomato Order,Lifestyle & Entertainment,Dining & Restaurants
01-Feb-25,-,499.0,92662.41,Netflix Subscription,Lifestyle & Entertainment,Subscription Services
01-Feb-25,79097.99,-,171760.4,Infosys Salary Credit,Income & Credits,Salary & Wages
02-Feb-25,-,1488.54,170271.86,Amazon India,Shopping,Clothing & Accessories
02-Feb-25,-,970.87,169300.99,Zomato Order,Lifestyle & Entertainment,Dining & Restaurants
02-Feb-25,-,748.23,168552.76,Zomato Order,Lifestyle & Entertainment,Dining & Restaurants
02-Feb-25,-,2464.19,166088.57,BigBasket Groceries,Food & Grocery,Online Grocery Services
03-Feb-25,-,781.38,165307.19,Zomato Order,Lifestyle & Entertainment,Dining & Restaurants
03-Feb-25,-,2439.18,162868.01,BigBasket Groceries,Food & Grocery,Online Grocery Services
03-Feb-25,-,499.0,162369.01,Netflix Subscription,Lifestyle & Entertainment,Subscription Services
04-Feb-25,-,1493.05,160875.96,Zomato Order,Lifestyle & Entertainment,Dining & Restaurants
04-Feb-25,-,928.8,159947.16,Amazon India,Shopping,Clothing & Accessories
04-Feb-25,-,1283.48,158663.68,Zomato Order,Lifestyle & Entertainment,Dining & Restaurants
04-Feb-25,-,2349.11,156314.57,Amazon India,Shopping,Clothing & Accessories
05-Feb-25,-,799.41,155515.16,Zomato Order,Lifestyle & Entertainment,Dining & Restaurants
05-Feb-25,-,1117.41,154397.75,BigBasket Groceries,Food & Grocery,Online Grocery Services
05-Feb-25,-,2626.56,151771.19,BigBasket Groceries,Food & Grocery,Online Grocery Services
06-Feb-25,-,1949.32,149821.87,BigBasket Groceries,Food & Grocery,Online Grocery Services
06-Feb-25,-,1026.87,148795.0,Zomato Order,Lifestyle & Entertainment,Dining & Restaurants
06-Feb-25,-,1204.77,147590.23,BigBasket Groceries,Food & Grocery,Online Grocery Services
07-Feb-25,-,1360.25,146229.98,BigBasket Groceries,Food & Grocery,Online Grocery Services
07-Feb-25,-,1609.85,144620.13,Amazon India,Shopping,Clothing & Accessories
07-Feb-25,-,499.0,144121.13,Netflix Subscription,Lifestyle & Entertainment,Subscription Services
07-Feb-25,-,499.0,143622.13,Netflix Subscription,Lifestyle & Entertainment,Subscription Services
08-Feb-25,-,1514.35,142107.78,BigBasket Groceries,Food & Grocery,Online Grocery Services
08-Feb-25,-,666.11,141441.67,Zomato Order,Lifestyle & Entertainment,Dining & Restaurants
08-Feb-25,-,499.0,140942.67,Netflix Subscription,Lifestyle & Entertainment,Subscription Services
08-Feb-25,-,865.06,140077.61,Zomato Order,Lifestyle & Entertainment,Dining & Restaurants
09-Feb-25,-,1650.37,138427.24,BigBasket Groceries,Food & Grocery,Online Grocery Services
09-Feb-25,-,499.0,137928.24,Netflix Subscription,Lifestyle & Entertainment,Subscription Services
09-Feb-25,-,888.2,137040.04,Amazon India,Shopping,Clothing & Accessories
09-Feb-25,-,499.0,136541.04,Netflix Subscription,Lifestyle & Entertainment,Subscription Services
10-Feb-25,-,1456.9,135084.14,BigBasket Groceries,Food & Grocery,Online Grocery Services
10-Feb-25,-,677.85,134406.29,Zomato Order,Lifestyle & Entertainment,Dining & Restaurants
10-Feb-25,-,2073.77,132332.52,BigBasket Groceries,Food & Grocery,Online Grocery Services
11-Feb-25,-,1155.18,131177.34,Zomato Order,Lifestyle & Entertainment,Dining & Restaurants
11-Feb-25,-,1856.78,129320.56,Amazon India,Shopping,Clothing & Accessories
11-Feb-25,-,499.0,128821.56,Netflix Subscription,Lifestyle & Entertainment,Subscription Services
11-Feb-25,-,1126.43,127695.13,Amazon India,Shopping,Clothing & Accessories
12-Feb-25,-,499.0,127196.13,Netflix Subscription,Lifestyle & Entertainment,Subscription Services
12-Feb-25,-,1756.38,125439.75,BigBasket Groceries,Food & Grocery,Online Grocery Services
12-Feb-25,-,1369.32,124070.43,Zomato Order,Lifestyle & Entertainment,Dining & Restaurants
12-Feb-25,-,499.0,123571.43,Netflix Subscription,Lifestyle & Entertainment,Subscription Services
13-Feb-25,-,499.0,123072.43,Netflix Subscription,Lifestyle & Entertainment,Subscription Services
13-Feb-25,-,963.22,122109.21,Amazon India,Shopping,Clothing & Accessories
13-Feb-25,-,1393.63,120715.58,Amazon India,Shopping,Clothing & Accessories
14-Feb-25,-,499.0,120216.58,Netflix Subscription,Lifestyle & Entertainment,Subscription Services
14-Feb-25,-,1788.0,118428.58,BigBasket Groceries,Food & Grocery,Online Grocery Services
14-Feb-25,-,1490.95,116937.63,Zomato Order,Lifestyle & Entertainment,Dining & Restaurants
14-Feb-25,-,1308.51,115629.12,Zomato Order,Lifestyle & Entertainment,Dining & Restaurants
15-Feb-25,-,1649.59,113979.53,BigBasket Groceries,Food & Grocery,Online Grocery Services
15-Feb-25,-,1987.56,111991.97,BigBasket Groceries,Food & Grocery,Online Grocery Services
15-Feb-25,-,959.83,111032.14,Zomato Order,Lifestyle & Entertainment,Dining & Restaurants
15-Feb-25,-,988.66,110043.48,Zomato Order,Lifestyle & Entertainment,Dining & Restaurants
16-Feb-25,-,1098.46,108945.02,Zomato Order,Lifestyle & Entertainment,Dining & Restaurants
16-Feb-25,-,499.0,108446.02,Netflix Subscription,Lifestyle & Entertainment,Subscription Services
16-Feb-25,-,499.0,107947.02,Netflix Subscription,Lifestyle & Entertainment,Subscription Services
16-Feb-25,-,499.0,107448.02,Netflix Subscription,Lifestyle & Entertainment,Subscription Services
17-Feb-25,-,499.0,106949.02,Netflix Subscription,Lifestyle & Entertainment,Subscription Services
17-Feb-25,-,1451.42,105497.6,Zomato Order,Lifestyle & Entertainment,Dining & Restaurants
17-Feb-25,-,1494.65,104002.95,Amazon India,Shopping,Clothing & Accessories
17-Feb-25,-,499.0,103503.95,Netflix Subscription,Lifestyle & Entertainment,Subscription Services
18-Feb-25,-,919.46,102584.49,Amazon India,Shopping,Clothing & Accessories
18-Feb-25,-,953.25,101631.24,Zomato Order,Lifestyle & Entertainment,Dining & Restaurants
18-Feb-25,-,1735.08,99896.16,Amazon India,Shopping,Clothing & Accessories
18-Feb-25,-,2770.73,97125.43,BigBasket Groceries,Food & Grocery,Online Grocery Services
19-Feb-25,-,1460.84,95664.59,BigBasket Groceries,Food & Grocery,Online Grocery Services
19-Feb-25,-,499.0,95165.59,Netflix Subscription,Lifestyle & Entertainment,Subscription Services
19-Feb-25,-,1359.25,93806.34,Zomato Order,Lifestyle & Entertainment,Dining & Restaurants
19-Feb-25,-,990.9,92815.44,Zomato Order,Lifestyle & Entertainment,Dining & Restaurants
20-Feb-25,-,1137.2,91678.24,Amazon India,Shopping,Clothing & Accessories
20-Feb-25,-,1167.91,90510.33,Amazon India,Shopping,Clothing & Accessories
20-Feb-25,-,499.0,90011.33,Netflix Subscription,Lifestyle & Entertainment,Subscription Services
20-Feb-25,-,1145.73,88865.6,Zomato Order,Lifestyle & Entertainment,Dining & Restaurants
21-Feb-25,-,1663.57,87202.03,Amazon India,Shopping,Clothing & Accessories
21-Feb-25,-,727.15,86474.88,Zomato Order,Lifestyle & Entertainment,Dining & Restaurants
21-Feb-25,-,1380.62,85094.26,BigBasket Groceries,Food & Grocery,Online Grocery Services
22-Feb-25,-,723.82,84370.44,Amazon India,Shopping,Clothing & Accessories
22-Feb-25,-,606.14,83764.3,Zomato Order,Lifestyle & Entertainment,Dining & Restaurants
22-Feb-25,-,937.49,82826.81,Zomato Order,Lifestyle & Entertainment,Dining & Restaurants
22-Feb-25,-,2955.3,79871.51,BigBasket Groceries,Food & Grocery,Online Grocery Services
23-Feb-25,-,1661.45,78210.06,BigBasket Groceries,Food & Grocery,Online Grocery Services
23-Feb-25,-,1895.84,76314.22,Amazon India,Shopping,Clothing & Accessories
23-Feb-25,-,2231.24,74082.98,Amazon India,Shopping,Clothing & Accessories
23-Feb-25,-,499.0,73583.98,Netflix Subscription,Lifestyle & Entertainment,Subscription Services
24-Feb-25,-,716.47,72867.51,Zomato Order,Lifestyle & Entertainment,Dining & Restaurants
24-Feb-25,-,2978.26,69889.25,BigBasket Groceries,Food & Grocery,Online Grocery Services
24-Feb-25,-,821.87,69067.38,Amazon India,Shopping,Clothing & Accessories
25-Feb-25,-,527.68,68539.7,Zomato Order,Lifestyle & Entertainment,Dining & Restaurants
25-Feb-25,-,1056.12,67483.58,Zomato Order,Lifestyle & Entertainment,Dining & Restaurants
25-Feb-25,-,499.0,66984.58,Netflix Subscription,Lifestyle & Entertainment,Subscription Services
26-Feb-25,-,1793.23,65191.35,Amazon India,Shopping,Clothing & Accessories
26-Feb-25,-,810.68,64380.67,Zomato Order,Lifestyle & Entertainment,Dining & Restaurants
26-Feb-25,-,714.24,63666.43,Amazon India,Shopping,Clothing & Accessories
27-Feb-25,-,2212.97,61453.46,BigBasket Groceries,Food & Grocery,Online Grocery Services
27-Feb-25,-,1070.11,60383.35,Zomato Order,Lifestyle & Entertainment,Dining & Restaurants
27-Feb-25,-,499.0,59884.35,Netflix Subscription,Lifestyle & Entertainment,Subscription Services
27-Feb-25,-,2483.23,57401.12,Amazon India,Shopping,Clothing & Accessories
28-Feb-25,-,1707.09,55694.03,Amazon India,Shopping,Clothing & Accessories
28-Feb-25,-,952.93,54741.1,Amazon India,Shopping,Clothing & Accessories
28-Feb-25,-,2038.75,52702.35,Amazon India,Shopping,Clothing & Accessories
01-Mar-25,-,694.98,52007.37,Zomato Order,Lifestyle & Entertainment,Dining & Restaurants
01-Mar-25,-,499.0,51508.37,Netflix Subscription,Lifestyle & Entertainment,Subscription Services
01-Mar-25,-,618.55,50889.82,Zomato Order,Lifestyle & Entertainment,Dining & Restaurants
01-Mar-25,-,499.0,50390.82,Netflix Subscription,Lifestyle & Entertainment,Subscription Services
01-Mar-25,-,1417.21,48973.61,Relocation Cab Charges,Transportation & Commute,Cab & Taxi services
02-Mar-25,-,499.0,48474.61,Netflix Subscription,Lifestyle & Entertainment,Subscription Services
02-Mar-25,-,1384.25,47090.36,Zomato Order,Lifestyle & Entertainment,Dining & Restaurants
02-Mar-25,-,499.0,46591.36,Netflix Subscription,Lifestyle & Entertainment,Subscription Services
02-Mar-25,-,3720.56,42870.8,LinkedIn Learning,Education & Childcare,Skill Development & Vocational Courses
03-Mar-25,-,1151.08,41719.72,Zomato Order,Lifestyle & Entertainment,Dining & Restaurants
03-Mar-25,-,499.0,41220.72,Netflix Subscription,Lifestyle & Entertainment,Subscription Services
03-Mar-25,-,946.33,40274.39,Zomato Order,Lifestyle & Entertainment,Dining & Restaurants
03-Mar-25,-,1008.63,39265.76,Zomato Order,Lifestyle & Entertainment,Dining & Restaurants
03-Mar-25,-,11080.56,28185.2,Work From Home Desk Setup,Shopping,Gadget & Electronics purchases
04-Mar-25,-,499.0,27686.2,Netflix Subscription,Lifestyle & Entertainment,Subscription Services
04-Mar-25,-,1323.63,26362.57,BigBasket Groceries,Food & Grocery,Online Grocery Services
04-Mar-25,-,2025.72,24336.85,BigBasket Groceries,Food & Grocery,Online Grocery Services
04-Mar-25,-,499.0,23837.85,Netflix Subscription,Lifestyle & Entertainment,Subscription Services
05-Mar-25,-,1455.23,22382.62,BigBasket Groceries,Food & Grocery,Online Grocery Services
05-Mar-25,-,2911.62,19471.0,BigBasket Groceries,Food & Grocery,Online Grocery Services
05-Mar-25,-,1339.74,18131.26,BigBasket Groceries,Food & Grocery,Online Grocery Services
05-Mar-25,-,2450.84,15680.42,Amazon India,Shopping,Clothing & Accessories
06-Mar-25,-,1434.94,14245.48,Amazon India,Shopping,Clothing & Accessories
06-Mar-25,-,1856.36,12389.12,Amazon India,Shopping,Clothing & Accessories
06-Mar-25,-,499.0,11890.12,Netflix Subscription,Lifestyle & Entertainment,Subscription Services
06-Mar-25,-,758.34,11131.78,Zomato Order,Lifestyle & Entertainment,Dining & Restaurants
07-Mar-25,-,2464.58,8667.2,BigBasket Groceries,Food & Grocery,Online Grocery Services
07-Mar-25,-,499.0,8168.2,Netflix Subscription,Lifestyle & Entertainment,Subscription Services
07-Mar-25,-,1431.84,6736.36,Zomato Order,Lifestyle & Entertainment,Dining & Restaurants
08-Mar-25,-,1100.61,5635.75,BigBasket Groceries,Food & Grocery,Online Grocery Services
08-Mar-25,-,2127.84,3507.91,BigBasket Groceries,Food & Grocery,Online Grocery Services
08-Mar-25,-,1754.73,1753.18,Amazon India,Shopping,Clothing & Accessories
09-Mar-25,-,1488.34,264.84,Amazon India,Shopping,Clothing & Accessories
09-Mar-25,-,760.71,-495.87,Zomato Order,Lifestyle & Entertainment,Dining & Restaurants
09-Mar-25,-,499.0,-994.87,Netflix Subscription,Lifestyle & Entertainment,Subscription Services
10-Mar-25,-,1582.34,-2577.21,Amazon India,Shopping,Clothing & Accessories
10-Mar-25,-,499.0,-3076.21,Netflix Subscription,Lifestyle & Entertainment,Subscription Services
10-Mar-25,-,1252.65,-4328.86,Amazon India,Shopping,Clothing & Accessories
10-Mar-25,-,950.41,-5279.27,Amazon India,Shopping,Clothing & Accessories
10-Mar-25,12537.92,-,7258.65,Freelance Upwork Payment,Income & Credits,Business Income
11-Mar-25,-,1292.47,5966.18,Zomato Order,Lifestyle & Entertainment,Dining & Restaurants
11-Mar-25,-,499.0,5467.18,Netflix Subscription,Lifestyle & Entertainment,Subscription Services
11-Mar-25,-,499.0,4968.18,Netflix Subscription,Lifestyle & Entertainment,Subscription Services
12-Mar-25,-,2432.35,2535.83,Amazon India,Shopping,Clothing & Accessories
12-Mar-25,-,976.47,1559.36,Zomato Order,Lifestyle & Entertainment,Dining & Restaurants
12-Mar-25,-,1019.86,539.5,Zomato Order,Lifestyle & Entertainment,Dining & Restaurants
13-Mar-25,-,499.0,40.5,Netflix Subscription,Lifestyle & Entertainment,Subscription Services
13-Mar-25,-,2402.92,-2362.42,Amazon India,Shopping,Clothing & Accessories
13-Mar-25,-,1231.02,-3593.44,BigBasket Groceries,Food & Grocery,Online Grocery Services
13-Mar-25,-,936.86,-4530.3,Zomato Order,Lifestyle & Entertainment,Dining & Restaurants
14-Mar-25,-,1626.67,-6156.97,Amazon India,Shopping,Clothing & Accessories
14-Mar-25,-,1191.67,-7348.64,Amazon India,Shopping,Clothing & Accessories
14-Mar-25,-,2067.23,-9415.87,BigBasket Groceries,Food & Grocery,Online Grocery Services
15-Mar-25,-,978.25,-10394.12,Amazon India,Shopping,Clothing & Accessories
15-Mar-25,-,2168.33,-12562.45,Amazon India,Shopping,Clothing & Accessories
15-Mar-25,-,2589.86,-15152.31,BigBasket Groceries,Food & Grocery,Online Grocery Services
16-Mar-25,-,553.79,-15706.1,Zomato Order,Lifestyle & Entertainment,Dining & Restaurants
16-Mar-25,-,1949.0,-17655.1,Amazon India,Shopping,Clothing & Accessories
16-Mar-25,-,2155.94,-19811.04,BigBasket Groceries,Food & Grocery,Online Grocery Services
16-Mar-25,-,743.48,-20554.52,Zomato Order,Lifestyle & Entertainment,Dining & Restaurants
17-Mar-25,-,499.0,-21053.52,Netflix Subscription,Lifestyle & Entertainment,Subscription Services
17-Mar-25,-,499.0,-21552.52,Netflix Subscription,Lifestyle & Entertainment,Subscription Services
17-Mar-25,-,583.73,-22136.25,Zomato Order,Lifestyle & Entertainment,Dining & Restaurants
17-Mar-25,-,1160.79,-23297.04,BigBasket Groceries,Food & Grocery,Online Grocery Services
18-Mar-25,-,499.0,-23796.04,Netflix Subscription,Lifestyle & Entertainment,Subscription Services
18-Mar-25,-,499.0,-24295.04,Netflix Subscription,Lifestyle & Entertainment,Subscription Services
18-Mar-25,-,668.67,-24963.71,Zomato Order,Lifestyle & Entertainment,Dining & Restaurants
19-Mar-25,-,2168.8,-27132.51,Amazon India,Shopping,Clothing & Accessories
19-Mar-25,-,2200.82,-29333.33,Amazon India,Shopping,Clothing & Accessories
19-Mar-25,-,759.86,-30093.19,Zomato Order,Lifestyle & Entertainment,Dining & Restaurants
20-Mar-25,-,1029.43,-31122.62,Amazon India,Shopping,Clothing & Accessories
20-Mar-25,-,499.0,-31621.62,Netflix Subscription,Lifestyle & Entertainment,Subscription Services
20-Mar-25,-,834.97,-32456.59,Zomato Order,Lifestyle & Entertainment,Dining & Restaurants
20-Mar-25,-,2959.32,-35415.91,BigBasket Groceries,Food & Grocery,Online Grocery Services
21-Mar-25,-,2871.05,-38286.96,BigBasket Groceries,Food & Grocery,Online Grocery Services
21-Mar-25,-,1132.06,-39419.02,Amazon India,Shopping,Clothing & Accessories
21-Mar-25,-,499.0,-39918.02,Netflix Subscription,Lifestyle & Entertainment,Subscription Services
22-Mar-25,-,499.0,-40417.02,Netflix Subscription,Lifestyle & Entertainment,Subscription Services
22-Mar-25,-,1940.1,-42357.12,Amazon India,Shopping,Clothing & Accessories
22-Mar-25,-,1987.85,-44344.97,Amazon India,Shopping,Clothing & Accessories
23-Mar-25,-,713.7,-45058.67,Amazon India,Shopping,Clothing & Accessories
23-Mar-25,-,1296.57,-46355.24,Zomato Order,Lifestyle & Entertainment,Dining & Restaurants
23-Mar-25,-,499.0,-46854.24,Netflix Subscription,Lifestyle & Entertainment,Subscription Services
24-Mar-25,-,966.51,-47820.75,Amazon India,Shopping,Clothing & Accessories
24-Mar-25,-,1746.5,-49567.25,Amazon India,Shopping,Clothing & Accessories
24-Mar-25,-,2934.33,-52501.58,BigBasket Groceries,Food & Grocery,Online Grocery Services
25-Mar-25,-,2102.1,-54603.68,Amazon India,Shopping,Clothing & Accessories
25-Mar-25,-,989.2,-55592.88,Zomato Order,Lifestyle & Entertainment,Dining & Restaurants
25-Mar-25,-,827.11,-56419.99,Zomato Order,Lifestyle & Entertainment,Dining & Restaurants
26-Mar-25,-,499.0,-56918.99,Netflix Subscription,Lifestyle & Entertainment,Subscription Services
26-Mar-25,-,1392.19,-58311.18,Zomato Order,Lifestyle & Entertainment,Dining & Restaurants
26-Mar-25,-,778.32,-59089.5,Zomato Order,Lifestyle & Entertainment,Dining & Restaurants
26-Mar-25,-,1421.4,-60510.9,Zomato Order,Lifestyle & Entertainment,Dining & Restaurants
27-Mar-25,-,2481.37,-62992.27,Amazon India,Shopping,Clothing & Accessories
27-Mar-25,-,1219.38,-64211.65,BigBasket Groceries,Food & Grocery,Online Grocery Services
27-Mar-25,-,813.69,-65025.34,Amazon India,Shopping,Clothing & Accessories
28-Mar-25,-,2329.35,-67354.69,Amazon India,Shopping,Clothing & Accessories
28-Mar-25,-,2533.15,-69887.84,BigBasket Groceries,Food & Grocery,Online Grocery Services
28-Mar-25,-,694.74,-70582.58,Zomato Order,Lifestyle & Entertainment,Dining & Restaurants
28-Mar-25,-,1587.54,-72170.12,Amazon India,Shopping,Clothing & Accessories
29-Mar-25,-,1200.67,-73370.79,BigBasket Groceries,Food & Grocery,Online Grocery Services
29-Mar-25,-,499.0,-73869.79,Netflix Subscription,Lifestyle & Entertainment,Subscription Services
29-Mar-25,-,1070.89,-74940.68,Zomato Order,Lifestyle & Entertainment,Dining & Restaurants
29-Mar-25,-,2502.4,-77443.08,BigBasket Groceries,Food & Grocery,Online Grocery Services
30-Mar-25,-,499.0,-77942.08,Netflix Subscription,Lifestyle & Entertainment,Subscription Services
30-Mar-25,-,499.0,-78441.08,Netflix Subscription,Lifestyle & Entertainment,Subscription Services
30-Mar-25,-,2355.38,-80796.46,Amazon India,Shopping,Clothing & Accessories
31-Mar-25,-,643.94,-81440.4,Zomato Order,Lifestyle & Entertainment,Dining & Restaurants
31-Mar-25,-,2591.65,-84032.05,BigBasket Groceries,Food & Grocery,Online Grocery Services
31-Mar-25,-,1878.32,-85910.37,Amazon India,Shopping,Clothing & Accessories
01-Apr-25,-,792.06,-86702.43,Amazon India,Shopping,Clothing & Accessories
01-Apr-25,-,499.0,-87201.43,Netflix Subscription,Lifestyle & Entertainment,Subscription Services
01-Apr-25,-,1110.74,-88312.17,BigBasket Groceries,Food & Grocery,Online Grocery Services
01-Apr-25,68528.2,-,-19783.97,New Startup Salary,Income & Credits,Salary & Wages
01-Apr-25,-,3956.65,-23740.62,LinkedIn Learning,Education & Childcare,Skill Development & Vocational Courses
02-Apr-25,-,499.0,-24239.62,Netflix Subscription,Lifestyle & Entertainment,Subscription Services
02-Apr-25,-,1701.66,-25941.28,Amazon India,Shopping,Clothing & Accessories
02-Apr-25,-,1834.08,-27775.36,BigBasket Groceries,Food & Grocery,Online Grocery Services
02-Apr-25,-,2680.85,-30456.21,Relocation Cab Charges,Transportation & Commute,Cab & Taxi services
03-Apr-25,-,2531.15,-32987.36,BigBasket Groceries,Food & Grocery,Online Grocery Services
03-Apr-25,-,499.0,-33486.36,Netflix Subscription,Lifestyle & Entertainment,Subscription Services
03-Apr-25,-,1473.44,-34959.8,Zomato Order,Lifestyle & Entertainment,Dining & Restaurants
03-Apr-25,-,913.97,-35873.77,Zomato Order,Lifestyle & Entertainment,Dining & Restaurants
03-Apr-25,-,9801.37,-45675.14,Work From Home Desk Setup,Shopping,Gadget & Electronics purchases
04-Apr-25,-,499.0,-46174.14,Netflix Subscription,Lifestyle & Entertainment,Subscription Services
04-Apr-25,-,1643.04,-47817.18,BigBasket Groceries,Food & Grocery,Online Grocery Services
04-Apr-25,-,2016.38,-49833.56,BigBasket Groceries,Food & Grocery,Online Grocery Services
04-Apr-25,-,2430.74,-52264.3,LinkedIn Learning,Education & Childcare,Skill Development & Vocational Courses
05-Apr-25,-,499.0,-52763.3,Netflix Subscription,Lifestyle & Entertainment,Subscription Services
05-Apr-25,-,1821.25,-54584.55,Amazon India,Shopping,Clothing & Accessories
05-Apr-25,-,1420.89,-56005.44,Zomato Order,Lifestyle & Entertainment,Dining & Restaurants
05-Apr-25,-,1650.39,-57655.83,Relocation Cab Charges,Transportation & Commute,Cab & Taxi services
06-Apr-25,-,613.57,-58269.4,Zomato Order,Lifestyle & Entertainment,Dining & Restaurants
06-Apr-25,-,1108.35,-59377.75,Zomato Order,Lifestyle & Entertainment,Dining & Restaurants
06-Apr-25,-,1300.8,-60678.55,Amazon India,Shopping,Clothing & Accessories
06-Apr-25,-,1026.52,-61705.07,Zomato Order,Lifestyle & Entertainment,Dining & Restaurants
06-Apr-25,-,14406.09,-76111.16,Work From Home Desk Setup,Shopping,Gadget & Electronics purchases
07-Apr-25,-,499.0,-76610.16,Netflix Subscription,Lifestyle & Entertainment,Subscription Services
07-Apr-25,-,2620.65,-79230.81,BigBasket Groceries,Food & Grocery,Online Grocery Services
07-Apr-25,-,499.0,-79729.81,Netflix Subscription,Lifestyle & Entertainment,Subscription Services
08-Apr-25,-,1021.55,-80751.36,Amazon India,Shopping,Clothing & Accessories
08-Apr-25,-,1215.93,-81967.29,Zomato Order,Lifestyle & Entertainment,Dining & Restaurants
08-Apr-25,-,2012.18,-83979.47,Amazon India,Shopping,Clothing & Accessories
09-Apr-25,-,499.0,-84478.47,Netflix Subscription,Lifestyle & Entertainment,Subscription Services
09-Apr-25,-,747.17,-85225.64,Zomato Order,Lifestyle & Entertainment,Dining & Restaurants
09-Apr-25,-,2195.21,-87420.85,Amazon India,Shopping,Clothing & Accessories
09-Apr-25,-,1165.87,-88586.72,BigBasket Groceries,Food & Grocery,Online Grocery Services
10-Apr-25,-,499.0,-89085.72,Netflix Subscription,Lifestyle & Entertainment,Subscription Services
10-Apr-25,-,499.0,-89584.72,Netflix Subscription,Lifestyle & Entertainment,Subscription Services
10-Apr-25,-,2233.55,-91818.27,BigBasket Groceries,Food & Grocery,Online Grocery Services
10-Apr-25,-,1588.6,-93406.87,Amazon India,Shopping,Clothing & Accessories
10-Apr-25,12710.44,-,-80696.43,Freelance Upwork Payment,Income & Credits,Business Income
11-Apr-25,-,1088.08,-81784.51,Amazon India,Shopping,Clothing & Accessories
11-Apr-25,-,499.0,-82283.51,Netflix Subscription,Lifestyle & Entertainment,Subscription Services
11-Apr-25,-,2792.64,-85076.15,BigBasket Groceries,Food & Grocery,Online Grocery Services
11-Apr-25,-,2214.22,-87290.37,Amazon India,Shopping,Clothing & Accessories
12-Apr-25,-,2301.29,-89591.66,Amazon India,Shopping,Clothing & Accessories
12-Apr-25,-,1001.51,-90593.17,BigBasket Groceries,Food & Grocery,Online Grocery Services
12-Apr-25,-,2998.15,-93591.32,BigBasket Groceries,Food & Grocery,Online Grocery Services
13-Apr-25,-,2754.13,-96345.45,BigBasket Groceries,Food & Grocery,Online Grocery Services
13-Apr-25,-,619.31,-96964.76,Zomato Order,Lifestyle & Entertainment,Dining & Restaurants
13-Apr-25,-,2527.03,-99491.79,BigBasket Groceries,Food & Grocery,Online Grocery Services
14-Apr-25,-,2630.8,-102122.59,BigBasket Groceries,Food & Grocery,Online Grocery Services
14-Apr-25,-,1699.51,-103822.1,Amazon India,Shopping,Clothing & Accessories
14-Apr-25,-,499.0,-104321.1,Netflix Subscription,Lifestyle & Entertainment,Subscription Services
14-Apr-25,-,499.0,-104820.1,Netflix Subscription,Lifestyle & Entertainment,Subscription Services
15-Apr-25,-,882.78,-105702.88,Amazon India,Shopping,Clothing & Accessories
15-Apr-25,-,1831.6,-107534.48,BigBasket Groceries,Food & Grocery,Online Grocery Services
15-Apr-25,-,499.0,-108033.48,Netflix Subscription,Lifestyle & Entertainment,Subscription Services
15-Apr-25,-,1688.36,-109721.84,BigBasket Groceries,Food & Grocery,Online Grocery Services
16-Apr-25,-,499.0,-110220.84,Netflix Subscription,Lifestyle & Entertainment,Subscription Services
16-Apr-25,-,2003.27,-112224.11,BigBasket Groceries,Food & Grocery,Online Grocery Services
16-Apr-25,-,2150.65,-114374.76,BigBasket Groceries,Food & Grocery,Online Grocery Services
17-Apr-25,-,2492.13,-116866.89,Amazon India,Shopping,Clothing & Accessories
17-Apr-25,-,1875.38,-118742.27,Amazon India,Shopping,Clothing & Accessories
17-Apr-25,-,521.83,-119264.1,Zomato Order,Lifestyle & Entertainment,Dining & Restaurants
18-Apr-25,-,1046.72,-120310.82,Amazon India,Shopping,Clothing & Accessories
18-Apr-25,-,1951.01,-122261.83,Amazon India,Shopping,Clothing & Accessories
18-Apr-25,-,2022.14,-124283.97,BigBasket Groceries,Food & Grocery,Online Grocery Services
19-Apr-25,-,1205.71,-125489.68,Amazon India,Shopping,Clothing & Accessories
19-Apr-25,-,499.0,-125988.68,Netflix Subscription,Lifestyle & Entertainment,Subscription Services
19-Apr-25,-,2842.03,-128830.71,BigBasket Groceries,Food & Grocery,Online Grocery Services
19-Apr-25,-,2854.42,-131685.13,BigBasket Groceries,Food & Grocery,Online Grocery Services
20-Apr-25,-,499.0,-132184.13,Netflix Subscription,Lifestyle & Entertainment,Subscription Services
20-Apr-25,-,1891.17,-134075.3,Amazon India,Shopping,Clothing & Accessories
20-Apr-25,-,954.69,-135029.99,Amazon India,Shopping,Clothing & Accessories
21-Apr-25,-,1280.75,-136310.74,Amazon India,Shopping,Clothing & Accessories
21-Apr-25,-,1248.1,-137558.84,Zomato Order,Lifestyle & Entertainment,Dining & Restaurants
21-Apr-25,-,1137.8,-138696.64,Zomato Order,Lifestyle & Entertainment,Dining & Restaurants
21-Apr-25,-,2252.79,-140949.43,BigBasket Groceries,Food & Grocery,Online Grocery Services
22-Apr-25,-,499.0,-141448.43,Netflix Subscription,Lifestyle & Entertainment,Subscription Services
22-Apr-25,-,499.0,-141947.43,Netflix Subscription,Lifestyle & Entertainment,Subscription Services
22-Apr-25,-,2404.61,-144352.04,Amazon India,Shopping,Clothing & Accessories
23-Apr-25,-,865.93,-145217.97,Zomato Order,Lifestyle & Entertainment,Dining & Restaurants
23-Apr-25,-,2931.75,-148149.72,BigBasket Groceries,Food & Grocery,Online Grocery Services
23-Apr-25,-,1183.29,-149333.01,BigBasket Groceries,Food & Grocery,Online Grocery Services
24-Apr-25,-,1441.67,-150774.68,Amazon India,Shopping,Clothing & Accessories
24-Apr-25,-,499.0,-151273.68,Netflix Subscription,Lifestyle & Entertainment,Subscription Services
24-Apr-25,-,499.0,-151772.68,Netflix Subscription,Lifestyle & Entertainment,Subscription Services
25-Apr-25,-,1666.88,-153439.56,Amazon India,Shopping,Clothing & Accessories
25-Apr-25,-,1704.17,-155143.73,Amazon India,Shopping,Clothing & Accessories
25-Apr-25,-,499.0,-155642.73,Netflix Subscription,Lifestyle & Entertainment,Subscription Services
26-Apr-25,-,2213.23,-157855.96,Amazon India,Shopping,Clothing & Accessories
26-Apr-25,-,1027.59,-158883.55,Amazon India,Shopping,Clothing & Accessories
26-Apr-25,-,2462.55,-161346.1,BigBasket Groceries,Food & Grocery,Online Grocery Services
26-Apr-25,-,1742.43,-163088.53,Amazon India,Shopping,Clothing & Accessories
27-Apr-25,-,499.0,-163587.53,Netflix Subscription,Lifestyle & Entertainment,Subscription Services
27-Apr-25,-,499.0,-164086.53,Netflix Subscription,Lifestyle & Entertainment,Subscription Services
27-Apr-25,-,1731.51,-165818.04,Amazon India,Shopping,Clothing & Accessories
27-Apr-25,-,1302.84,-167120.88,Zomato Order,Lifestyle & Entertainment,Dining & Restaurants
28-Apr-25,-,1780.45,-168901.33,BigBasket Groceries,Food & Grocery,Online Grocery Services
28-Apr-25,-,499.0,-169400.33,Netflix Subscription,Lifestyle & Entertainment,Subscription Services
28-Apr-25,-,1699.55,-171099.88,BigBasket Groceries,Food & Grocery,Online Grocery Services
28-Apr-25,-,855.57,-171955.45,Zomato Order,Lifestyle & Entertainment,Dining & Restaurants
29-Apr-25,-,499.0,-172454.45,Netflix Subscription,Lifestyle & Entertainment,Subscription Services
29-Apr-25,-,1300.33,-173754.78,BigBasket Groceries,Food & Grocery,Online Grocery Services
29-Apr-25,-,1969.58,-175724.36,Amazon India,Shopping,Clothing & Accessories
29-Apr-25,-,1427.4,-177151.76,BigBasket Groceries,Food & Grocery,Online Grocery Services
30-Apr-25,-,1187.57,-178339.33,Zomato Order,Lifestyle & Entertainment,Dining & Restaurants
30-Apr-25,-,499.0,-178838.33,Netflix Subscription,Lifestyle & Entertainment,Subscription Services
30-Apr-25,-,1416.59,-180254.92,Zomato Order,Lifestyle & Entertainment,Dining & Restaurants
30-Apr-25,-,1195.2,-181450.12,BigBasket Groceries,Food & Grocery,Online Grocery Services
01-May-25,-,499.0,-181949.12,Netflix Subscription,Lifestyle & Entertainment,Subscription Services
01-May-25,-,1370.9,-183320.02,BigBasket Groceries,Food & Grocery,Online Grocery Services
01-May-25,-,499.0,-183819.02,Netflix Subscription,Lifestyle & Entertainment,Subscription Services
01-May-25,-,1162.9,-184981.92,Zomato Order,Lifestyle & Entertainment,Dining & Restaurants
01-May-25,66318.37,-,-118663.55,New Startup Salary,Income & Credits,Salary & Wages
01-May-25,-,3874.5,-122538.05,LinkedIn Learning,Education & Childcare,Skill Development & Vocational Courses
02-May-25,-,2292.9,-124830.95,Amazon India,Shopping,Clothing & Accessories
02-May-25,-,1440.46,-126271.41,Amazon India,Shopping,Clothing & Accessories
02-May-25,-,2354.04,-128625.45,BigBasket Groceries,Food & Grocery,Online Grocery Services
02-May-25,-,9216.25,-137841.7,Work From Home Desk Setup,Shopping,Gadget & Electronics purchases
03-May-25,-,499.0,-138340.7,Netflix Subscription,Lifestyle & Entertainment,Subscription Services
03-May-25,-,1667.79,-140008.49,Amazon India,Shopping,Clothing & Accessories
03-May-25,-,2420.36,-142428.85,Amazon India,Shopping,Clothing & Accessories
03-May-25,-,1812.44,-144241.29,Relocation Cab Charges,Transportation & Commute,Cab & Taxi services
04-May-25,-,1551.03,-145792.32,Amazon India,Shopping,Clothing & Accessories
04-May-25,-,1228.65,-147020.97,Amazon India,Shopping,Clothing & Accessories
04-May-25,-,1009.17,-148030.14,Amazon India,Shopping,Clothing & Accessories
04-May-25,-,919.22,-148949.36,Zomato Order,Lifestyle & Entertainment,Dining & Restaurants
04-May-25,-,2107.13,-151056.49,LinkedIn Learning,Education & Childcare,Skill Development & Vocational Courses
05-May-25,-,499.0,-151555.49,Netflix Subscription,Lifestyle & Entertainment,Subscription Services
05-May-25,-,2082.9,-153638.39,Amazon India,Shopping,Clothing & Accessories
05-May-25,-,1574.88,-155213.27,Amazon India,Shopping,Clothing & Accessories
05-May-25,-,499.0,-155712.27,Netflix Subscription,Lifestyle & Entertainment,Subscription Services
05-May-25,-,1062.02,-156774.29,Relocation Cab Charges,Transportation & Commute,Cab & Taxi services
06-May-25,-,1297.86,-158072.15,Zomato Order,Lifestyle & Entertainment,Dining & Restaurants
06-May-25,-,499.0,-158571.15,Netflix Subscription,Lifestyle & Entertainment,Subscription Services
06-May-25,-,1117.34,-159688.49,BigBasket Groceries,Food & Grocery,Online Grocery Services
06-May-25,-,2186.5,-161874.99,BigBasket Groceries,Food & Grocery,Online Grocery Services
06-May-25,-,2030.26,-163905.25,Relocation Cab Charges,Transportation & Commute,Cab & Taxi services
07-May-25,-,1324.72,-165229.97,Amazon India,Shopping,Clothing & Accessories
07-May-25,-,895.73,-166125.7,Zomato Order,Lifestyle & Entertainment,Dining & Restaurants
07-May-25,-,499.0,-166624.7,Netflix Subscription,Lifestyle & Entertainment,Subscription Services
07-May-25,-,2422.71,-169047.41,LinkedIn Learning,Education & Childcare,Skill Development & Vocational Courses
08-May-25,-,842.85,-169890.26,Zomato Order,Lifestyle & Entertainment,Dining & Restaurants
08-May-25,-,506.78,-170397.04,Zomato Order,Lifestyle & Entertainment,Dining & Restaurants
08-May-25,-,2119.38,-172516.42,Amazon India,Shopping,Clothing & Accessories
08-May-25,-,2237.86,-174754.28,BigBasket Groceries,Food & Grocery,Online Grocery Services
08-May-25,-,9058.34,-183812.62,Work From Home Desk Setup,Shopping,Gadget & Electronics purchases
09-May-25,-,1661.9,-185474.52,Amazon India,Shopping,Clothing & Accessories
09-May-25,-,499.0,-185973.52,Netflix Subscription,Lifestyle & Entertainment,Subscription Services
09-May-25,-,2091.89,-188065.41,BigBasket Groceries,Food & Grocery,Online Grocery Services
09-May-25,-,8443.03,-196508.44,Work From Home Desk Setup,Shopping,Gadget & Electronics purchases
10-May-25,-,967.45,-197475.89,Amazon India,Shopping,Clothing & Accessories
10-May-25,-,1088.35,-198564.24,Zomato Order,Lifestyle & Entertainment,Dining & Restaurants
10-May-25,-,676.07,-199240.31,Zomato Order,Lifestyle & Entertainment,Dining & Restaurants
10-May-25,-,499.0,-199739.31,Netflix Subscription,Lifestyle & Entertainment,Subscription Services
10-May-25,18671.2,-,-181068.11,Freelance Upwork Payment,Income & Credits,Business Income
11-May-25,-,938.28,-182006.39,Zomato Order,Lifestyle & Entertainment,Dining & Restaurants
11-May-25,-,1843.0,-183849.39,Amazon India,Shopping,Clothing & Accessories
11-May-25,-,1589.04,-185438.43,Amazon India,Shopping,Clothing & Accessories
12-May-25,-,1257.81,-186696.24,Zomato Order,Lifestyle & Entertainment,Dining & Restaurants
12-May-25,-,2469.74,-189165.98,Amazon India,Shopping,Clothing & Accessories
12-May-25,-,1078.32,-190244.3,BigBasket Groceries,Food & Grocery,Online Grocery Services
12-May-25,-,683.86,-190928.16,Zomato Order,Lifestyle & Entertainment,Dining & Restaurants
13-May-25,-,1926.45,-192854.61,BigBasket Groceries,Food & Grocery,Online Grocery Services
13-May-25,-,1659.42,-194514.03,Amazon India,Shopping,Clothing & Accessories
13-May-25,-,1711.6,-196225.63,BigBasket Groceries,Food & Grocery,Online Grocery Services
13-May-25,-,1934.63,-198160.26,BigBasket Groceries,Food & Grocery,Online Grocery Services
14-May-25,-,1281.98,-199442.24,Zomato Order,Lifestyle & Entertainment,Dining & Restaurants
14-May-25,-,796.82,-200239.06,Amazon India,Shopping,Clothing & Accessories
14-May-25,-,499.0,-200738.06,Netflix Subscription,Lifestyle & Entertainment,Subscription Services
14-May-25,-,499.0,-201237.06,Netflix Subscription,Lifestyle & Entertainment,Subscription Services
15-May-25,-,2966.54,-204203.6,BigBasket Groceries,Food & Grocery,Online Grocery Services
15-May-25,-,1866.87,-206070.47,BigBasket Groceries,Food & Grocery,Online Grocery Services
15-May-25,-,499.0,-206569.47,Netflix Subscription,Lifestyle & Entertainment,Subscription Services
15-May-25,-,805.78,-207375.25,Amazon India,Shopping,Clothing & Accessories
16-May-25,-,499.0,-207874.25,Netflix Subscription,Lifestyle & Entertainment,Subscription Services
16-May-25,-,499.0,-208373.25,Netflix Subscription,Lifestyle & Entertainment,Subscription Services
16-May-25,-,1123.39,-209496.64,Zomato Order,Lifestyle & Entertainment,Dining & Restaurants
17-May-25,-,499.0,-209995.64,Netflix Subscription,Lifestyle & Entertainment,Subscription Services
17-May-25,-,499.0,-210494.64,Netflix Subscription,Lifestyle & Entertainment,Subscription Services
17-May-25,-,499.0,-210993.64,Netflix Subscription,Lifestyle & Entertainment,Subscription Services
18-May-25,-,1343.08,-212336.72,Zomato Order,Lifestyle & Entertainment,Dining & Restaurants
18-May-25,-,2054.71,-214391.43,BigBasket Groceries,Food & Grocery,Online Grocery Services
18-May-25,-,1524.79,-215916.22,Amazon India,Shopping,Clothing & Accessories
19-May-25,-,1197.91,-217114.13,Zomato Order,Lifestyle & Entertainment,Dining & Restaurants
19-May-25,-,1296.38,-218410.51,Zomato Order,Lifestyle & Entertainment,Dining & Restaurants
19-May-25,-,499.0,-218909.51,Netflix Subscription,Lifestyle & Entertainment,Subscription Services
19-May-25,-,2284.14,-221193.65,BigBasket Groceries,Food & Grocery,Online Grocery Services
20-May-25,-,815.91,-222009.56,Zomato Order,Lifestyle & Entertainment,Dining & Restaurants
20-May-25,-,949.55,-222959.11,Zomato Order,Lifestyle & Entertainment,Dining & Restaurants
20-May-25,-,766.5,-223725.61,Zomato Order,Lifestyle & Entertainment,Dining & Restaurants
20-May-25,-,1380.74,-225106.35,Zomato Order,Lifestyle & Entertainment,Dining & Restaurants
21-May-25,-,756.64,-225862.99,Zomato Order,Lifestyle & Entertainment,Dining & Restaurants
21-May-25,-,790.05,-226653.04,Amazon India,Shopping,Clothing & Accessories
21-May-25,-,1391.15,-228044.19,Amazon India,Shopping,Clothing & Accessories
22-May-25,-,1192.4,-229236.59,Amazon India,Shopping,Clothing & Accessories
22-May-25,-,986.14,-230222.73,Amazon India,Shopping,Clothing & Accessories
22-May-25,-,792.89,-231015.62,Zomato Order,Lifestyle & Entertainment,Dining & Restaurants
23-May-25,-,1023.29,-232038.91,Zomato Order,Lifestyle & Entertainment,Dining & Restaurants
23-May-25,-,1443.14,-233482.05,Zomato Order,Lifestyle & Entertainment,Dining & Restaurants
23-May-25,-,2851.06,-236333.11,BigBasket Groceries,Food & Grocery,Online Grocery Services
23-May-25,-,499.0,-236832.11,Netflix Subscription,Lifestyle & Entertainment,Subscription Services
24-May-25,-,1274.33,-238106.44,BigBasket Groceries,Food & Grocery,Online Grocery Services
24-May-25,-,499.0,-238605.44,Netflix Subscription,Lifestyle & Entertainment,Subscription Services
24-May-25,-,499.0,-239104.44,Netflix Subscription,Lifestyle & Entertainment,Subscription Services
24-May-25,-,1422.41,-240526.85,Zomato Order,Lifestyle & Entertainment,Dining & Restaurants
25-May-25,-,1122.7,-241649.55,Zomato Order,Lifestyle & Entertainment,Dining & Restaurants
25-May-25,-,1436.15,-243085.7,Zomato Order,Lifestyle & Entertainment,Dining & Restaurants
25-May-25,-,1928.36,-245014.06,Amazon India,Shopping,Clothing & Accessories
26-May-25,-,2670.73,-247684.79,BigBasket Groceries,Food & Grocery,Online Grocery Services
26-May-25,-,499.0,-248183.79,Netflix Subscription,Lifestyle & Entertainment,Subscription Services
26-May-25,-,1159.71,-249343.5,Zomato Order,Lifestyle & Entertainment,Dining & Restaurants
27-May-25,-,1670.93,-251014.43,BigBasket Groceries,Food & Grocery,Online Grocery Services
27-May-25,-,1424.81,-252439.24,Amazon India,Shopping,Clothing & Accessories
27-May-25,-,499.0,-252938.24,Netflix Subscription,Lifestyle & Entertainment,Subscription Services
27-May-25,-,499.0,-253437.24,Netflix Subscription,Lifestyle & Entertainment,Subscription Services
28-May-25,-,2017.05,-255454.29,BigBasket Groceries,Food & Grocery,Online Grocery Services
28-May-25,-,1311.72,-256766.01,Zomato Order,Lifestyle & Entertainment,Dining & Restaurants
28-May-25,-,499.0,-257265.01,Netflix Subscription,Lifestyle & Entertainment,Subscription Services
29-May-25,-,499.0,-257764.01,Netflix Subscription,Lifestyle & Entertainment,Subscription Services
29-May-25,-,2301.47,-260065.48,BigBasket Groceries,Food & Grocery,Online Grocery Services
29-May-25,-,1299.72,-261365.2,BigBasket Groceries,Food & Grocery,Online Grocery Services
29-May-25,-,1082.31,-262447.51,Zomato Order,Lifestyle & Entertainment,Dining & Restaurants
30-May-25,-,499.0,-262946.51,Netflix Subscription,Lifestyle & Entertainment,Subscription Services
30-May-25,-,1087.28,-264033.79,BigBasket Groceries,Food & Grocery,Online Grocery Services
30-May-25,-,1034.99,-265068.78,BigBasket Groceries,Food & Grocery,Online Grocery Services
30-May-25,-,1002.54,-266071.32,Amazon India,Shopping,Clothing & Accessories
31-May-25,-,2355.04,-268426.36,Amazon India,Shopping,Clothing & Accessories
31-May-25,-,499.0,-268925.36,Netflix Subscription,Lifestyle & Entertainment,Subscription Services
31-May-25,-,1466.31,-270391.67,Zomato Order,Lifestyle & Entertainment,Dining & Restaurants
31-May-25,-,1848.62,-272240.29,Amazon India,Shopping,Clothing & Accessories
01-Jun-25,-,774.34,-273014.63,Zomato Order,Lifestyle & Entertainment,Dining & Restaurants
01-Jun-25,-,2745.59,-275760.22,BigBasket Groceries,Food & Grocery,Online Grocery Services
01-Jun-25,-,533.08,-276293.3,Zomato Order,Lifestyle & Entertainment,Dining & Restaurants
01-Jun-25,-,1298.25,-277591.55,Zomato Order,Lifestyle & Entertainment,Dining & Restaurants
01-Jun-25,65323.73,-,-212267.82,New Startup Salary,Income & Credits,Salary & Wages
01-Jun-25,-,1369.02,-213636.84,Relocation Cab Charges,Transportation & Commute,Cab & Taxi services
02-Jun-25,-,1152.34,-214789.18,BigBasket Groceries,Food & Grocery,Online Grocery Services
02-Jun-25,-,1408.98,-216198.16,Amazon India,Shopping,Clothing & Accessories
02-Jun-25,-,1742.07,-217940.23,BigBasket Groceries,Food & Grocery,Online Grocery Services
02-Jun-25,-,2493.73,-220433.96,LinkedIn Learning,Education & Childcare,Skill Development & Vocational Courses
03-Jun-25,-,777.17,-221211.13,Amazon India,Shopping,Clothing & Accessories
03-Jun-25,-,2723.17,-223934.3,BigBasket Groceries,Food & Grocery,Online Grocery Services
03-Jun-25,-,499.0,-224433.3,Netflix Subscription,Lifestyle & Entertainment,Subscription Services
03-Jun-25,-,499.0,-224932.3,Netflix Subscription,Lifestyle & Entertainment,Subscription Services
03-Jun-25,-,3596.23,-228528.53,LinkedIn Learning,Education & Childcare,Skill Development & Vocational Courses
04-Jun-25,-,1335.27,-229863.8,BigBasket Groceries,Food & Grocery,Online Grocery Services
04-Jun-25,-,1163.52,-231027.32,BigBasket Groceries,Food & Grocery,Online Grocery Services
04-Jun-25,-,499.0,-231526.32,Netflix Subscription,Lifestyle & Entertainment,Subscription Services
04-Jun-25,-,1161.7,-232688.02,BigBasket Groceries,Food & Grocery,Online Grocery Services
04-Jun-25,-,10062.62,-242750.64,Work From Home Desk Setup,Shopping,Gadget & Electronics purchases
05-Jun-25,-,499.0,-243249.64,Netflix Subscription,Lifestyle & Entertainment,Subscription Services
05-Jun-25,-,499.0,-243748.64,Netflix Subscription,Lifestyle & Entertainment,Subscription Services
05-Jun-25,-,1575.33,-245323.97,BigBasket Groceries,Food & Grocery,Online Grocery Services
05-Jun-25,-,13012.69,-258336.66,Work From Home Desk Setup,Shopping,Gadget & Electronics purchases
06-Jun-25,-,1548.42,-259885.08,Amazon India,Shopping,Clothing & Accessories
06-Jun-25,-,2785.89,-262670.97,BigBasket Groceries,Food & Grocery,Online Grocery Services
06-Jun-25,-,2574.1,-265245.07,BigBasket Groceries,Food & Grocery,Online Grocery Services
06-Jun-25,-,507.56,-265752.63,Zomato Order,Lifestyle & Entertainment,Dining & Restaurants
06-Jun-25,-,10013.53,-275766.16,Work From Home Desk Setup,Shopping,Gadget & Electronics purchases
07-Jun-25,-,1127.88,-276894.04,Zomato Order,Lifestyle & Entertainment,Dining & Restaurants
07-Jun-25,-,1182.52,-278076.56,BigBasket Groceries,Food & Grocery,Online Grocery Services
07-Jun-25,-,1965.69,-280042.25,BigBasket Groceries,Food & Grocery,Online Grocery Services
07-Jun-25,-,1034.95,-281077.2,Zomato Order,Lifestyle & Entertainment,Dining & Restaurants
07-Jun-25,-,2391.13,-283468.33,Relocation Cab Charges,Transportation & Commute,Cab & Taxi services
08-Jun-25,-,499.0,-283967.33,Netflix Subscription,Lifestyle & Entertainment,Subscription Services
08-Jun-25,-,1829.48,-285796.81,BigBasket Groceries,Food & Grocery,Online Grocery Services
08-Jun-25,-,1799.92,-287596.73,Amazon India,Shopping,Clothing & Accessories
08-Jun-25,-,1086.98,-288683.71,Relocation Cab Charges,Transportation & Commute,Cab & Taxi services
09-Jun-25,-,499.0,-289182.71,Netflix Subscription,Lifestyle & Entertainment,Subscription Services
09-Jun-25,-,1151.66,-290334.37,Amazon India,Shopping,Clothing & Accessories
09-Jun-25,-,499.0,-290833.37,Netflix Subscription,Lifestyle & Entertainment,Subscription Services
09-Jun-25,-,2419.57,-293252.94,LinkedIn Learning,Education & Childcare,Skill Development & Vocational Courses
10-Jun-25,-,499.0,-293751.94,Netflix Subscription,Lifestyle & Entertainment,Subscription Services
10-Jun-25,-,1425.64,-295177.58,Amazon India,Shopping,Clothing & Accessories
10-Jun-25,-,2598.55,-297776.13,BigBasket Groceries,Food & Grocery,Online Grocery Services
10-Jun-25,-,1175.67,-298951.8,Zomato Order,Lifestyle & Entertainment,Dining & Restaurants
10-Jun-25,11818.25,-,-287133.55,Freelance Upwork Payment,Income & Credits,Business Income
10-Jun-25,-,3591.26,-290724.81,LinkedIn Learning,Education & Childcare,Skill Development & Vocational Courses
11-Jun-25,-,1129.39,-291854.2,Zomato Order,Lifestyle & Entertainment,Dining & Restaurants
11-Jun-25,-,1479.96,-293334.16,Amazon India,Shopping,Clothing & Accessories
11-Jun-25,-,1824.84,-295159.0,Amazon India,Shopping,Clothing & Accessories
11-Jun-25,-,950.06,-296109.06,Amazon India,Shopping,Clothing & Accessories
11-Jun-25,-,14958.13,-311067.19,Work From Home Desk Setup,Shopping,Gadget & Electronics purchases
12-Jun-25,-,1901.75,-312968.94,Amazon India,Shopping,Clothing & Accessories
12-Jun-25,-,1094.81,-314063.75,BigBasket Groceries,Food & Grocery,Online Grocery Services
12-Jun-25,-,1953.77,-316017.52,Amazon India,Shopping,Clothing & Accessories
12-Jun-25,-,2698.62,-318716.14,Relocation Cab Charges,Transportation & Commute,Cab & Taxi services
13-Jun-25,-,499.0,-319215.14,Netflix Subscription,Lifestyle & Entertainment,Subscription Services
13-Jun-25,-,499.0,-319714.14,Netflix Subscription,Lifestyle & Entertainment,Subscription Services
13-Jun-25,-,1388.29,-321102.43,Zomato Order,Lifestyle & Entertainment,Dining & Restaurants
14-Jun-25,-,499.0,-321601.43,Netflix Subscription,Lifestyle & Entertainment,Subscription Services
14-Jun-25,-,499.0,-322100.43,Netflix Subscription,Lifestyle & Entertainment,Subscription Services
14-Jun-25,-,2332.24,-324432.67,Amazon India,Shopping,Clothing & Accessories
15-Jun-25,-,499.0,-324931.67,Netflix Subscription,Lifestyle & Entertainment,Subscription Services
15-Jun-25,-,1317.9,-326249.57,Zomato Order,Lifestyle & Entertainment,Dining & Restaurants
15-Jun-25,-,1425.71,-327675.28,BigBasket Groceries,Food & Grocery,Online Grocery Services
16-Jun-25,-,2574.44,-330249.72,BigBasket Groceries,Food & Grocery,Online Grocery Services
16-Jun-25,-,733.65,-330983.37,Zomato Order,Lifestyle & Entertainment,Dining & Restaurants
16-Jun-25,-,1538.08,-332521.45,BigBasket Groceries,Food & Grocery,Online Grocery Services
17-Jun-25,-,2201.82,-334723.27,BigBasket Groceries,Food & Grocery,Online Grocery Services
17-Jun-25,-,1642.58,-336365.85,Amazon India,Shopping,Clothing & Accessories
17-Jun-25,-,1680.79,-338046.64,BigBasket Groceries,Food & Grocery,Online Grocery Services
17-Jun-25,-,499.0,-338545.64,Netflix Subscription,Lifestyle & Entertainment,Subscription Services
18-Jun-25,-,499.0,-339044.64,Netflix Subscription,Lifestyle & Entertainment,Subscription Services
18-Jun-25,-,1168.52,-340213.16,Zomato Order,Lifestyle & Entertainment,Dining & Restaurants
18-Jun-25,-,2173.92,-342387.08,BigBasket Groceries,Food & Grocery,Online Grocery Services
19-Jun-25,-,1729.41,-344116.49,Amazon India,Shopping,Clothing & Accessories
19-Jun-25,-,499.0,-344615.49,Netflix Subscription,Lifestyle & Entertainment,Subscription Services
19-Jun-25,-,2489.81,-347105.3,Amazon India,Shopping,Clothing & Accessories
19-Jun-25,-,2277.15,-349382.45,BigBasket Groceries,Food & Grocery,Online Grocery Services
20-Jun-25,-,2206.55,-351589.0,Amazon India,Shopping,Clothing & Accessories
20-Jun-25,-,2399.46,-353988.46,Amazon India,Shopping,Clothing & Accessories
20-Jun-25,-,590.97,-354579.43,Zomato Order,Lifestyle & Entertainment,Dining & Restaurants
21-Jun-25,-,2742.1,-357321.53,BigBasket Groceries,Food & Grocery,Online Grocery Services
21-Jun-25,-,499.0,-357820.53,Netflix Subscription,Lifestyle & Entertainment,Subscription Services
21-Jun-25,-,1395.22,-359215.75,Zomato Order,Lifestyle & Entertainment,Dining & Restaurants
21-Jun-25,-,499.0,-359714.75,Netflix Subscription,Lifestyle & Entertainment,Subscription Services
22-Jun-25,-,2328.38,-362043.13,BigBasket Groceries,Food & Grocery,Online Grocery Services
22-Jun-25,-,720.93,-362764.06,Zomato Order,Lifestyle & Entertainment,Dining & Restaurants
22-Jun-25,-,499.0,-363263.06,Netflix Subscription,Lifestyle & Entertainment,Subscription Services
22-Jun-25,-,2741.21,-366004.27,BigBasket Groceries,Food & Grocery,Online Grocery Services
23-Jun-25,-,1465.75,-367470.02,BigBasket Groceries,Food & Grocery,Online Grocery Services
23-Jun-25,-,2796.05,-370266.07,BigBasket Groceries,Food & Grocery,Online Grocery Services
23-Jun-25,-,2064.66,-372330.73,Amazon India,Shopping,Clothing & Accessories
23-Jun-25,-,869.61,-373200.34,Zomato Order,Lifestyle & Entertainment,Dining & Restaurants
24-Jun-25,-,838.75,-374039.09,Amazon India,Shopping,Clothing & Accessories
24-Jun-25,-,916.45,-374955.54,Zomato Order,Lifestyle & Entertainment,Dining & Restaurants
24-Jun-25,-,499.0,-375454.54,Netflix Subscription,Lifestyle & Entertainment,Subscription Services
25-Jun-25,-,499.0,-375953.54,Netflix Subscription,Lifestyle & Entertainment,Subscription Services
25-Jun-25,-,1752.27,-377705.81,BigBasket Groceries,Food & Grocery,Online Grocery Services
25-Jun-25,-,2746.77,-380452.58,BigBasket Groceries,Food & Grocery,Online Grocery Services
25-Jun-25,-,499.0,-380951.58,Netflix Subscription,Lifestyle & Entertainment,Subscription Services
26-Jun-25,-,499.0,-381450.58,Netflix Subscription,Lifestyle & Entertainment,Subscription Services
26-Jun-25,-,1802.64,-383253.22,BigBasket Groceries,Food & Grocery,Online Grocery Services
26-Jun-25,-,1446.66,-384699.88,Amazon India,Shopping,Clothing & Accessories
26-Jun-25,-,1673.31,-386373.19,Amazon India,Shopping,Clothing & Accessories
27-Jun-25,-,1821.49,-388194.68,Amazon India,Shopping,Clothing & Accessories
27-Jun-25,-,1309.0,-389503.68,Zomato Order,Lifestyle & Entertainment,Dining & Restaurants
27-Jun-25,-,1817.91,-391321.59,Amazon India,Shopping,Clothing & Accessories
27-Jun-25,-,1674.58,-392996.17,Amazon India,Shopping,Clothing & Accessories
28-Jun-25,-,2219.47,-395215.64,Amazon India,Shopping,Clothing & Accessories
28-Jun-25,-,2097.58,-397313.22,Amazon India,Shopping,Clothing & Accessories
28-Jun-25,-,1495.91,-398809.13,Zomato Order,Lifestyle & Entertainment,Dining & Restaurants
28-Jun-25,-,817.88,-399627.01,Zomato Order,Lifestyle & Entertainment,Dining & Restaurants
29-Jun-25,-,862.23,-400489.24,Amazon India,Shopping,Clothing & Accessories
29-Jun-25,-,1271.61,-401760.85,Amazon India,Shopping,Clothing & Accessories
29-Jun-25,-,2244.4,-404005.25,BigBasket Groceries,Food & Grocery,Online Grocery Services
29-Jun-25,-,2070.74,-406075.99,BigBasket Groceries,Food & Grocery,Online Grocery Services
30-Jun-25,-,2054.89,-408130.88,BigBasket Groceries,Food & Grocery,Online Grocery Services
30-Jun-25,-,1362.24,-409493.12,Zomato Order,Lifestyle & Entertainment,Dining & Restaurants
30-Jun-25,-,2657.87,-412150.99,BigBasket Groceries,Food & Grocery,Online Grocery Services
